xwwwwwwww
x.ww.ww.w
x.......w
x.......w
x..www..w
x..www..w
x.......w
x.......w
xwwwwwwww